border_size=1
usage=map

Ha          , Ha          , Ha          , Ms          , Ms          , Ms          , Ms          , Ha          , Aa          , Ai          , Ai          , Aa          , Aa          , Gg          , Aa          , Aa          , Aa          , Aa          , Gg          , Gg          , Gg          , Gg          
Ha          , Ha          , Ms          , Ms          , Ms          , Ms          , Ms          , Ms          , Ha          , Ha          , Ai          , Ai          , Aa          , Aa          , Aa          , Aa          , Aa          , Aa          , Aa^Fda      , Gg          , Aa          , Aa          
Ha          , Ha^Fpa      , Ha^Fda      , Ms          , Ms          , Ms          , Ms          , Ms          , Aa^Fma      , Aa          , Ai          , Ai          , Aa          , Aa          , Aa^Fma      , Aa          , Aa^Fma      , Aa          , Aa^Fma      , Aa^Fda      , Aa          , Aa          
Ha          , Ha^Fpa      , Ha^Fpa      , Ha^Fpa      , Ms          , Rr^Vd       , Ha^Fpa      , Ha^Fma      , Ha^Fma      , Aa          , Aa          , Ai          , Ai          , Aa          , Ha^Fpa      , Ha^Fpa      , Ha^Fpa      , Ha^Fma      , Ha^Fpa      , Aa          , Aa          , Aa          
Ha          , Ha^Fpa      , Ha^Fpa      , Ha^Fpa      , Ha          , Ha^Fpa      , Ha          , Ha^Fpa      , Ha          , Ha          , Ai          , Ai          , Ai          , Ha          , Ha          , Ha^Fpa      , Ms          , Ha^Fpa      , Ha          , Ha^Fma      , Ha^Fpa      , Ha^Fpa      
Ha          , Ha          , Ha          , Ha          , Ha          , Ha^Fpa      , Ha          , Ha^Fpa      , Ai          , Ai          , Chr         , Ha^Fpa      , Ha^Fpa      , Ai          , Ai          , Ha          , Rr^Vd       , Ms          , Ha          , Ha          , Ha          , Ha          
Ms          , Ms          , Rr^Vd       , Ha          , Ha          , Ha          , Ai          , Ai          , Ms          , Chr         , Chr         , Chr         , Chr         , Ha          , Ai          , Ha          , Ha          , Ha          , Ms          , Ms          , Ms          , Ha          
Ms          , Ms          , Ms          , Ms          , Ai          , Ai          , Ms          , Ms          , Ms          , Ms          , Ms          , 2 Khr       , Ms          , Chr         , Ms          , Ai          , Ai          , Ms          , Ms          , Rr^Vd       , Ms          , Ms          
Ms          , Ms          , Ai          , Ai          , Ms          , Ms          , Ms          , Rr^Vd       , Ms          , Ms          , Ms          , Ms          , Ms          , Ms          , Ms          , Ms          , Ms          , Ai          , Ms          , Ms          , Ms          , Ms          
Ms          , Ai          , Ai          , Ai          , Ms          , Ms          , Ms          , Ms          , Ms          , Ms          , Ms          , Ms          , Ms          , Ms          , Ms          , Ms          , Ms          , Ai          , Ai          , Ai          , Ms          , Ms          
Ms          , Ms          , Ms          , Ms          , Ms          , Ms          , Ms          , Ms          , Ms          , Ms          , Ms          , Ms          , Ms          , Ms          , Rr^Vd       , Ms          , Ms          , Ai          , Ai          , Ai          , Ai          , Ms          
Ms          , Ms          , Ms          , Ms          , Ms          , Ms          , Ms          , Rr^Vd       , Ms          , Ms          , Ms          , Ms          , Ms          , Ms          , Ms          , Ms          , Ms          , Ms          , Ms          , Ms          , Ms          , Ms          
Ms          , Ms          , Rr^Vd       , Ms          , Ms          , Ms          , Ms          , Ms          , Ms          , Ms          , Ms          , Ms          , Ms          , Ms          , Ms          , Ms          , Ms          , Ms          , Ms          , Rr^Vd       , Ms          , Ms          
Ms          , Ms          , Ms          , Ms          , Ms          , Ms          , Ms          , Ms          , Ha          , Ha          , Ha          , Ms          , Ms          , Ms          , Ms          , Ms          , Ms          , Ms          , Rr^Vd       , Ms          , Ms          , Ms          
Ms          , Ms          , Ms          , Ms          , Ms          , Rr^Vd       , Ha          , Ha          , Ai          , Ai          , Ai          , Ha          , Ha          , Ms          , Rr^Vd       , Ms          , Ms          , Ms          , Ms          , Ms          , Ms          , Ms          
Ms          , Ms          , Ms          , Ms          , Ms          , Ms          , Ha          , Ai          , Ai          , Ai          , Ai          , Ai          , Ha          , Ms          , Ms          , Ms          , Ms          , Ms          , Ms          , Ms          , Ms          , Ms          
Ms          , Ms          , Ms          , Ms          , Ms          , Ms          , Ha          , Ai          , Ai          , Ai          , Ai          , Ai          , Ha          , Ms          , Ms          , Ms          , Ms          , Ms          , Ms          , Ms          , Ms          , Ms          
Ms          , Ms          , Ms          , Ms          , Rr^Vd       , Ms          , Ms          , Ha          , Ha          , Ai          , Ha          , Ha          , Ms          , Ms          , Ms          , Ms          , Ms          , Ms          , Ms          , Rr^Vd       , Ms          , Ms          
Ms          , Ms          , Ms          , Ms          , Ms          , Ms          , Ms          , Ha          , Ms          , Ha          , Ms          , Ms          , Ms          , Ms          , Ms          , Ms          , Ms          , Ms          , Ms          , Ms          , Ms          , Ms          
Ms          , Ms          , Ms          , Ms          , Ms          , Ms          , Ms          , Ms          , Cud         , Ms          , Cud         , Ms          , Ms          , Ms          , Rr^Vd       , Ms          , Ms          , Ms          , Rr^Vd       , Ms          , Ms          , Ms          
Ms          , Ms          , Ms          , Rr^Vd       , Ms          , Cud         , Cud         , Cud         , 1 Kud       , Cud         , Ms          , Ms          , Ms          , Ms          , Ms          , Ms          , Ms          , Ms          , Ms          , Ms          , Ms          , Ms          
Ms          , Ms          , Ms          , Ms          , Ms          , Ms          , Ms          , Uu          , Uu          , Ms          , Ms          , Ms          , Ms          , Ms          , Ms          , Ms          , Ms          , Ms          , Ms          , Ms          , Ms          , Ms          
