border_size=1
usage=map

Hh          , Hh          , Hh          , Mm          , Mm          , Mm          , Mm          , Hh          , Gg          , Ww          , Ww          , Gg          , Gg          , Gg          , Rr          , Rr          , Gg          , Gg          , Gg          , Gg          , Gg          , Gg          
Hh          , Hh          , Mm          , Mm          , Mm          , Mm          , Mm          , Mm          , Hh          , Hh          , Ww          , Ww          , Rr          , Rr          , Rr          , Rr          , Gg          , Gg          , Gs^Fds      , Gg          , Gg          , Gg          
Hh          , Hh^Fp       , Hh^Fds      , Mm          , Mm          , Mm          , Mm          , Mm          , Gs^Fms      , Gg          , Ww^Bw/      , Ww^Bw/      , Rr^Bw/      , Rr          , Gs^Fdw      , Gg          , Gs^Fdw      , Gg          , Gs^Fms      , Gs^Fds      , Gg          , Gg          
Hh          , Hh^Fp       , Hh^Fp       , Hh^Fdw      , Mm          , Hh^Vo       , Hh^Fdw      , Hh^Fms      , Hh^Fms      , Gg          , Gg^Bw|      , Ww^Bw|      , Ww          , Gg          , Hh^Fdw      , Hh^Fdw      , Hh^Fdw      , Hh^Fms      , Hh^Fp       , Gg          , Gg          , Gg          
Hh          , Hh^Fp       , Hh^Fp       , Hh^Fp       , Hh          , Hh^Fdw      , Hh          , Hh^Fp       , Hh          , Hh          , Ww^Bw|      , Ww^Bw|      , Ww          , Hh          , Hh          , Hh^Fdw      , Mm          , Hh^Fp       , Hh          , Hh^Fms      , Hh^Fp       , Hh^Fp       
Hh          , Hh          , Hh          , Hh          , Hh          , Hh^Fp       , Hh          , Hh^Fp       , Ww          , Ww          , Co          , Hh^Bw|      , Hh^Fdw      , Ww          , Ww          , Hh          , Hh^Vo       , Mm          , Hh          , Hh          , Hh          , Hh          
Mm          , Mm          , Hh^Vo       , Hh          , Hh          , Hh          , Ww          , Ww          , Co          , Co          , Co          , Co          , Co          , Hh          , Ww          , Hh          , Hh          , Hh          , Mm          , Mm          , Mm          , Hh          
Mm          , Mm          , Mm          , Mm          , Ww          , Ww          , Mm          , Co          , Mm          , Mm          , Mm          , Ko          , Mm          , Co          , Co          , Ww          , Ww          , Mm          , Mm          , Hh^Vo       , Mm          , Mm          
Mm          , Mm          , Ww          , Ww          , Mm          , Mm          , Mm          , Hh^Vo       , Mm          , Mm          , Mm          , Mm          , Mm          , Mm          , Mm          , Mm          , Mm          , Ww          , Mm          , Mm          , Mm          , Mm          
Mm          , Ww          , Ww          , Ww          , Mm          , Mm          , Mm          , Mm          , Mm          , Mm          , Mm          , Mm          , Mm          , Mm          , Mm          , Mm          , Mm          , Ww          , Ww          , Ww          , Mm          , Mm          
Mm          , Mm          , Mm          , Mm          , Mm          , Mm          , Mm          , Mm          , Mm          , Mm          , Mm          , Mm          , Mm          , Mm          , Hh^Vo       , Mm          , Mm          , Ww          , Ww          , Ww          , Ww          , Mm          
Mm          , Mm          , Mm          , Mm          , Mm          , Mm          , Mm          , Hh^Vo       , Mm          , Mm          , Mm          , Mm          , Mm          , Mm          , Mm          , Mm          , Mm          , Mm          , Mm          , Mm          , Mm          , Mm          
Mm          , Mm          , Hh^Vo       , Mm          , Mm          , Mm          , Mm          , Mm          , Mm          , Mm          , Mm          , Mm          , Mm          , Mm          , Mm          , Mm          , Mm          , Mm          , Mm          , Hh^Vo       , Mm          , Mm          
Mm          , Mm          , Mm          , Mm          , Mm          , Mm          , Mm          , Mm          , Hh          , Hh          , Hh          , Mm          , Mm          , Mm          , Mm          , Mm          , Mm          , Mm          , Hh^Vo       , Mm          , Mm          , Mm          
Mm          , Mm          , Mm          , Mm          , Mm          , Hh^Vo       , Hh          , Hh          , Ww          , Ww          , Ww          , Hh          , Hh          , Mm          , Hh^Vo       , Mm          , Mm          , Mm          , Mm          , Mm          , Mm          , Mm          
Mm          , Mm          , Mm          , Mm          , Mm          , Mm          , Hh          , Ww          , Wo          , Wo          , Wo          , Ww          , Hh          , Mm          , Mm          , Mm          , Mm          , Mm          , Mm          , Mm          , Mm          , Mm          
Mm          , Mm          , Mm          , Mm          , Mm          , Mm          , Hh          , Ww          , Ww          , Wo          , Ww          , Ww          , Hh          , Mm          , Mm          , Mm          , Mm          , Mm          , Mm          , Mm          , Mm          , Mm          
Mm          , Mm          , Mm          , Mm          , Hh^Vo       , Mm          , Mm          , Hh          , Hh          , Ww          , Hh          , Hh          , Mm          , Mm          , Mm          , Mm          , Mm          , Mm          , Mm          , Hh^Vo       , Mm          , Mm          
Mm          , Mm          , Mm          , Mm          , Mm          , Mm          , Mm          , Hh          , Mm          , Hh          , Mm          , Mm          , Mm          , Mm          , Mm          , Mm          , Mm          , Mm          , Mm          , Mm          , Mm          , Mm          
Mm          , Mm          , Mm          , Mm          , Mm          , Mm          , Mm          , Mm          , Cud         , Mm          , Cud         , Mm          , Mm          , Mm          , Hh^Vo       , Mm          , Mm          , Mm          , Hh^Vo       , Mm          , Mm          , Mm          
Mm          , Mm          , Mm          , Hh^Vo       , Mm          , Cud         , Cud         , Cud         , Kud         , Cud         , Mm          , Mm          , Mm          , Mm          , Mm          , Mm          , Mm          , Mm          , Mm          , Mm          , Mm          , Mm          
Mm          , Mm          , Mm          , Mm          , Mm          , Mm          , Mm          , Uu          , Uu          , Mm          , Mm          , Mm          , Mm          , Mm          , Mm          , Mm          , Mm          , Mm          , Mm          , Mm          , Mm          , Mm          
