border_size=1
usage=map

Ms          , Ms          , Ms          , Ms          , Ms          , Ms          , Ms          , Ms          , Ms          , Ms          , Ms          , Ms          , Ms          , Ms          , Ms          , Ms          , Ms          , Ms          , Ms          , Ms          , Ms          , Ms          , Ms          , Ms          , Ms          , Ms          , Ms          , Ms          , Ms          , Ms          , Ms          
Ms          , Ms          , Ms          , Ms          , Ms          , Ms          , Ms          , Ms          , Ms          , Ms          , Ms          , Ms          , Ms          , Ms          , Ms          , Ms          , Ms          , Ms          , Ms          , Ms          , Ms          , Ms          , Ms          , Ms          , Ms          , Ms          , Ms          , Ms          , Ms          , Ms          , Ms          
Ms          , Ms          , Aa^Fpa      , Ms          , Ha          , Ms          , Ms          , Ms          , Ms          , Ms          , Ha          , Ms          , Ha^Fpa      , Ms          , Ha          , Ms          , Aa          , Ms          , Ms          , Ha^Fpa      , Ha^Fpa      , Ha          , Ha^Fpa      , Ha          , Ha          , Ms          , Aa^Fpa      , Ms          , Ms          , Ms          , Ms          
Aa^Fma      , Ms          , Ha^Fpa      , Ha          , Ha          , Ha          , Ha          , Ms          , Ha^Fpa      , Ha          , Ha^Fpa      , Ha^Fpa      , Ha^Fpa      , Ha          , Aa          , Aa          , Aa          , Aa          , Aa          , Ms          , Aa^Vea      , Ha^Fpa      , Ha^Fpa      , Ha^Fpa      , Ha^Fpa      , Ha^Fpa      , Ha^Fpa      , Ha^Fpa      , Ha^Fpa      , Ms          , Ha          
Aa^Fma      , Ha^Fpa      , Ha^Fpa      , Ha^Fpa      , Ha^Fpa      , Ha^Fpa      , Ha^Fpa      , Ha^Fpa      , Ha^Fpa      , Ha^Fma      , Ha          , Ha          , Ha          , Aa          , Aa          , Aa          , Aa          , Aa          , Aa          , Ms          , Aa          , Aa          , Aa^Fpa      , Ha^Fpa      , Aa^Fma      , Ha^Fpa      , Ha^Fma      , Ha^Fpa      , Ha^Fma      , Ha          , Ha^Fpa      
Aa^Fma      , Ha^Fpa      , Ha^Fda      , Ha^Fma      , Ha^Fma      , Ha^Fma      , Ha^Fda      , Ha^Fpa      , Ha^Fpa      , Ha^Fma      , Aa          , Aa^Vea      , Aa^Fpa      , Aa^Fpa      , Rr          , Aa          , Rr          , Aa          , Ha^Fpa      , Aa          , Aa          , Aa^Fpa      , Aa^Fpa      , Aa^Fda      , Aa^Fpa      , Ha^Fda      , Ha^Fda      , Ha^Fda      , Ha^Fpa      , Ha^Fma      , Ha^Fma      
Aa^Fma      , Aa^Fma      , Aa^Fpa      , Ha^Fma      , Aa^Fma      , Aa^Fma      , Aa^Fma      , Ha^Fda      , Aa^Fma      , Aa^Fma      , Aa          , Aa^Fpa      , Rr          , Rr          , Ha^Fpa      , Rr          , Ha          , Rr          , Rr          , Aa^Fpa      , Aa          , Aa          , Aa          , Aa^Fpa      , Aa^Fpa      , Aa^Fma      , Ai          , Ai          , Aa^Vea      , Aa^Fda      , Aa^Fma      
Aa^Fpa      , Aa^Fpa      , Aa^Vea      , Aa^Fma      , Aa^Fpa      , Aa^Fma      , Aa^Fpa      , 2 Kv        , Kv          , Aa^Fma      , Rr          , Rr          , Ha          , Ha          , Ms          , Ha          , Ms          , Ha          , Rr          , Aa^Fpa      , Aa^Fpa      , Aa^Fpa      , Rr          , Aa^Fpa      , Aa          , Aa^Fda      , Ai          , Aa^Vea      , Aa^Vea      , Aa^Fpa      , Aa^Fma      
Aa^Fma      , Ai          , Aa^Vea      , Aa^Vea      , Aa^Fda      , Aa^Fma      , Aa^Fma      , Aa^Fpa      , Kv          , Rr          , Aa          , Aa          , Ha          , Ms          , Ms          , Ms          , Ha          , Aa          , Aa          , Rr          , Rr          , Rr          , Aa          , Rr          , Rr          , Aa^Fma      , Ai          , Aa^Fda      , Aa^Fpa      , Aa^Fma      , Aa^Fma      
Aa^Fpa      , Ai          , Ha^Fpa      , Ha^Fpa      , Ha^Fpa      , Aa^Fma      , Aa^Fda      , Aa^Fpa      , Kv          , Aa          , Aa          , Aa          , Aa          , Ms          , Ms          , Ms          , Ha^Fpa      , Aa^Vea      , Aa          , Aa          , Aa          , Aa          , Aa          , Aa          , Aa          , Ai^Bw\      , Kv          , 3 Kv        , Aa^Fda      , Aa^Fma      , Ha^Fpa      
Aa^Fda      , Aa^Fma      , Aa^Fma      , Ha^Fda      , Aa^Fda      , Aa^Fma      , Aa^Fma      , Kv          , Aa          , Aa          , Aa          , Aa          , Aa          , Aa          , Ha^Fma      , Ha^Fpa      , Ha^Fma      , Aa          , Aa          , Aa          , Aa          , Aa          , Aa          , Aa          , Ai          , Ai          , Kv          , Aa^Fpa      , Aa^Fma      , Ha^Fda      , Ha^Fpa      
Aa^Fma      , Aa^Fma      , Aa^Fma      , Aa^Fma      , Aa^Fpa      , Aa^Fma      , Aa^Fma      , Rr          , Ha^Fpa      , Aa          , Aa          , Aa          , Aa          , Aa          , Aa          , Aa          , Aa          , Aa^Fda      , Aa          , Aa          , Aa          , Ai          , Ai          , Ai          , Aa          , Aa          , Kv          , Aa^Fpa      , Aa^Fpa      , Aa^Fma      , Ha^Fda      
Aa^Fpa      , Aa^Fma      , Aa^Fpa      , Aa^Fpa      , Aa^Fpa      , Aa^Fma      , Aa          , Rr          , Aa          , Aa          , Aa          , Ha^Fpa      , Ha^Fpa      , Aa          , Aa          , Aa          , Aa          , Aa          , Aa          , Aa          , Ai          , Ai          , Ww          , Ai          , Aa          , Aa          , Rr          , Kv          , Aa^Fma      , Aa^Fma      , Aa^Fma      
Aa^Fpa      , Aa^Fma      , Aa^Fma      , Aa^Fda      , Aa^Fpa      , Aa^Fma      , Aa^Vea      , Rr          , Aa          , Aa          , Aa^Fpa      , Aa^Fma      , Aa          , Aa          , Aa          , Aa          , Aa          , Aa          , Aa          , Ai          , Ai          , Ww          , Ai          , Ai          , Aa          , Rr          , Aa          , Aa^Fma      , Aa^Fpa      , Aa^Fma      , Aa^Fma      
Aa          , Aa^Fma      , Aa^Fda      , Aa^Fma      , Aa          , Aa          , Aa          , Rr          , Aa          , Aa          , Aa          , Aa^Fda      , Aa          , Aa          , Aa          , Aa          , Aa          , Aa^Vea      , Aa          , Ai          , Ai          , Ai          , Aa          , Aa          , Aa          , Rr          , Aa          , Aa^Fma      , Aa^Fma      , Aa^Fda      , Aa^Fma      
Aa          , Aa          , Aa          , Aa          , Aa          , Aa          , Aa          , Rr          , Aa          , Aa          , Aa          , Aa          , Aa          , Aa          , Aa          , Ha^Fpa      , Aa^Fma      , Aa^Fda      , Aa          , Aa          , Aa          , Ai          , Aa          , Aa          , Rr          , Rr          , Aa          , Aa^Vea      , Aa^Fpa      , Aa^Fma      , Aa^Fma      
Aa          , Aa          , Aa          , Aa          , Aa          , Aa          , Aa          , Rr          , Ha^Fpa      , Aa          , Aa^Vea      , Aa          , Aa          , Aa          , Ms          , Aa          , Aa          , Aa^Fma      , Aa          , Aa          , Aa          , Aa          , Aa          , Aa          , Rr          , Aa          , Aa          , Aa          , Aa^Fpa      , Aa^Fpa      , Aa^Fpa      
Aa^Fpa      , Aa          , Aa          , Aa          , Aa          , Aa          , Rr          , Rr          , Ha^Fpa      , Ha^Fpa      , Aa^Fpa      , Aa          , Aa          , Aa          , Aa          , Ha          , Aa          , Aa          , Aa          , Aa          , Aa          , Aa          , Rr          , Rr          , Aa          , Aa          , Aa          , Aa          , Aa          , Aa          , Aa^Fma      
Aa^Fma      , Aa          , Aa          , Aa          , Aa          , Rr          , Aa^Fpa      , Aa^Fpa      , Aa          , Aa          , Aa^Fpa      , Aa^Fma      , Aa^Fda      , Aa          , Aa          , Aa          , Aa          , Aa          , Aa          , Aa          , Rr          , Rr          , Aa          , Aa^Vea      , Aa          , Aa          , Aa          , Aa          , Aa          , Aa          , Aa^Fma      
Aa          , Aa^Fma      , Aa          , Aa          , Aa          , Rr          , Aa          , Aa^Fma      , Aa^Fma      , Aa^Fpa      , Aa          , Aa^Fda      , Aa          , Aa          , Rr          , Aa          , Aa          , Aa          , Rr          , Rr          , Aa          , Aa          , Aa          , Aa          , Aa^Fpa      , Aa          , Aa^Fpa      , Aa          , Aa          , Aa          , Aa          
Aa          , Aa          , Aa          , Aa          , Aa          , Rr          , Aa^Fpa      , Aa^Fpa      , Aa^Fma      , Aa^Fda      , Rr          , Aa          , Rr          , Rr          , Aa          , Rr          , Rr          , Rr          , Aa          , Aa          , Aa          , Aa          , Aa          , Aa          , Aa^Fpa      , Aa          , Aa          , Aa          , Aa          , Aa          , Aa          
Aa          , Aa          , Aa          , Aa          , Aa          , Rr          , Aa^Vea      , Aa^Fpa      , Rr          , Rr          , Aa          , Rr          , Aa          , Aa          , Aa          , Aa          , Aa          , Aa          , Aa          , Aa          , Aa          , Aa          , Ha^Fma      , Aa          , Aa          , Aa          , Ha^Fma      , Aa          , Aa          , Aa          , Aa          
Aa          , Aa          , Aa          , Aa          , Rr          , Rr          , Rr          , Rr          , Aa          , Aa          , Aa          , Aa          , Aa          , Aa          , Aa          , Aa          , Re^Vct      , Aa          , Aa          , Aa          , Aa          , Aa          , Aa          , Aa          , Aa          , Ms          , Ms          , Ha          , Aa          , Aa          , Aa          
Rr          , Aa^Vea      , Rr          , Rr          , Aa          , Aa          , Ha^Fma      , Aa          , Aa          , Aa          , Aa          , Aa          , Aa          , Aa          , Re          , Re          , Re          , Aa          , Re^Vct      , Aa          , Aa          , Aa          , Aa          , Aa          , Ha          , Ha^Fma      , Ha^Fpa      , Aa          , Aa          , Aa          , Aa^Fma      
Aa          , Rr          , Aa          , Aa          , Aa          , Ha^Fma      , Ha^Fpa      , Ms          , Aa          , Aa          , Aa          , Aa          , Aa          , Aa          , Re          , Re          , Ce          , Re          , Re          , Aa          , Aa          , Aa          , Aa          , Aa          , Aa          , Ha          , Aa          , Aa          , Aa          , Aa          , Aa          
Aa^Fpa      , Aa          , Aa          , Aa          , Aa          , Ha          , Aa          , Aa          , Aa          , Aa          , Aa          , Aa          , Aa          , Re^Vct      , Aa          , Ce          , 1 Ke        , Ce          , Ce          , Aa          , Aa          , Aa          , Aa          , Aa^Fpa      , Aa          , Aa          , Aa          , Aa          , Aa          , Aa          , Aa          
Aa          , Aa          , Aa          , Aa          , Aa          , Aa          , Aa^Fpa      , Aa^Fpa      , Aa          , Aa          , Aa^Fma      , Aa          , Aa          , Aa          , Re          , Ce          , Re          , Re          , Aa          , Aa          , Aa          , Aa          , Aa          , Aa          , Aa          , Aa          , Aa          , Aa          , Aa          , Aa          , Aa^Fpa      
Aa          , Aa          , Ha^Fpa      , Ha^Fpa      , Ha^Fpa      , Aa          , Aa          , Aa^Fma      , Aa^Fpa      , Ai          , Ai          , Aa          , Aa          , Re^Vct      , Re          , Ce          , Aa          , Re          , Re          , Aa          , Aa          , Aa          , Aa          , Aa          , Aa          , Aa          , Aa^Voa      , Aa          , Aa          , Aa          , Aa^Fpa      
Aa          , Aa          , Ha^Fma      , Ha^Fma      , Aa          , Aa          , Aa          , Aa          , Aa          , Aa^Fpa      , Aa^Voa      , Aa          , Aa          , Aa          , Aa          , Aa          , Aa          , Aa          , Aa          , Re          , Re          , Aa          , Aa          , Aa          , Aa          , Aa^Fpa      , Ai          , Aa          , Aa          , Aa          , Aa          
Aa          , Aa          , Aa          , Aa          , Aa          , Aa          , Aa          , Aa^Fpa      , Aa          , Aa          , Aa          , Aa          , Aa          , Aa          , Aa          , Aa          , Aa          , Aa          , Aa          , Aa          , Aa          , Re          , Aa          , Aa          , Aa          , Aa          , Aa          , Aa          , Aa          , Aa          , Aa          
Aa          , Aa          , Aa          , Aa          , Aa          , Aa          , Aa          , Aa          , Aa          , Aa          , Aa          , Aa          , Aa          , Aa          , Aa          , Aa          , Aa          , Aa          , Aa          , Aa          , Aa          , Re          , Re          , Aa          , Aa          , Aa          , Aa          , Aa          , Aa          , Aa          , Aa          
Aa          , Aa          , Aa          , Aa          , Aa          , Aa          , Aa          , Aa          , Aa          , Aa          , Aa          , Aa          , Aa          , Aa          , Aa          , Aa          , Aa          , Aa          , Aa          , Aa          , Aa          , Re          , Re          , Aa          , Aa          , Aa          , Aa          , Aa          , Aa          , Aa          , Aa          
