border_size=1
usage=map

Gs^Fmf      , Gs^Fp       , Gs^Fds      , Gs^Fp       , Gs^Fms      , Gs^Fds      , Hh^Fp       , Gs^Fp       , Gg          , Gg^Efm      , Gg^Efm      , Gg^Efm      , Gg          , Rd          , Rd          , Gs^Fp       , Gs^Fp       , Gs^Fp       , Gs^Fms      , Gs^Fms      , Gs^Fms      , Gs^Fms      , Gs^Fp       , Gs^Fp       , Gs^Fp       , Gs^Fp       , Gs^Fp       , Gg          , Gg          , Gg          , Gg^Efm      , Mm          , Mm          , Mm          , Mm          , Gg^Efm      , Gg^Efm      , Gs^Fms      , Gs^Fms      , Gs^Fmf      
Gs^Fp       , Gs^Fp       , Gs^Fds      , Gs^Fds      , Gs^Fms      , Hh^Fp       , Mm          , Mm          , Mm          , Gg^Efm      , Gg^Efm      , Gg^Efm      , Gg          , Rd          , Rd          , Gs^Fp       , Gs^Fp       , Gs^Fp       , Gs^Fds      , Gs^Fds      , Gs^Fp       , Gs^Fp       , Gs^Fp       , Gg          , Gg^Vl       , Gs^Fms      , Gs^Fms      , Gs^Fp       , Gs^Fp       , Gg          , Gg^Efm      , Gg^Efm      , Gg^Efm      , Mm          , Hh^Vc       , Gg          , Gg          , Gs^Fms      , Gs^Fmf      , Gs^Fmf      
Gs^Fp       , Gs^Fds      , Gs^Fp       , Gs^Fms      , Gs^Fms      , Mm          , Mm          , Mm          , Mm          , Mm          , Gs^Fp       , Gg          , Gg          , Rd          , Rd          , Rd          , Gs^Fp       , Gs^Fp       , Ss          , Gs^Fds      , Ss          , Gs^Fms      , Gs^Fp       , Gg          , Gs^Fp       , Gs^Fms      , Gs^Fms      , Gs^Fp       , Gs^Fp       , Gg          , Gg          , Gg          , Gs^Fp       , Hh          , Hh^Fms      , Hh^Fms      , Gg          , Gs^Fms      , Gg          , Gg          
Gg          , Gs^Fp       , Gg^Efm      , Gg^Efm      , Gs^Vht      , Gs^Fmf      , Hh^Fp       , Mm          , Hh^Fp       , Gs^Fp       , Gs^Fds      , Gs^Fp       , Gs^Fp       , Gg          , Rd          , Rd          , Rd          , Gs^Fp       , Ss          , Ss          , Gs^Fp       , Gs^Fms      , Gs^Fp       , Gg^Efm      , Gg^Efm      , Gs^Fp       , Gs^Fds      , Gs^Fds      , Gs^Fds      , Gs^Fp       , Gs^Fp       , Gs^Fp       , Gs^Fms      , Gs^Fp       , Gs^Fp       , Gs^Fp       , Gs^Fp       , Gg          , Gg          , Gg          
Gg^Efm      , Gg^Efm      , Gs^Fms      , Ww          , Ww          , Ss          , Ss          , Hh^Fp       , Hh^Fp       , Gs^Fds      , Gs^Fms      , Gs^Fms      , Gs^Fms      , Gs^Fp       , Gg          , Rd          , Rd          , Rd          , Gs^Fp       , Ss          , Gs^Fp       , Gs^Fp       , Gg          , Gs^Fms      , Gs^Fp       , Gs^Fp       , Gs^Fms      , Gs^Fds      , Gs^Fms      , Gs^Fms      , Chs         , Gs^Fds      , Gs^Fds      , Gs^Fms      , Gs^Fp       , Gs^Fp       , Gs^Fp       , Gg          , Gg          , Gg          
Gg          , Gg^Efm      , Gs^Fp       , Ww          , Gg^Efm      , Gs^Fp       , Gs^Fp       , Gs^Fp       , Gs^Fms      , Gs^Fp       , Gg^Efm      , Gs^Fp       , Gs^Fp       , Gg^Vc       , Gg          , Gg          , Rd          , Rd          , Gs^Fds      , Gs^Fds      , Gs^Fms      , Gg          , Gs^Fms      , Gs^Fms      , Gs^Fp       , Gs^Fp       , Gs^Fds      , Gs^Fms      , Chs         , Ss          , 2 Khs       , Gs^Fms      , Chs         , Gs^Fds      , Gs^Fp       , Gs^Fp       , Gs^Fp       , Gg          , Gs^Fds      , Gs^Fds      
Gs^Fp       , Gs^Fp       , Gs^Fms      , Gg^Efm      , Gs^Fds      , Gs^Fms      , Gs^Fp       , Gs^Fms      , Gg          , Gg^Efm      , Gs^Fds      , Gs^Fms      , Gs^Fds      , Gg          , Gg          , Gg          , Rd          , Rd          , Rd          , Gs^Fds      , Gs^Fds      , Gs^Fds      , Gs^Fds      , Gs^Fp       , Gs^Fp       , Gs^Fp       , Gs^Fms      , Chs         , Ss          , Chs         , Gs^Fms      , Gs^Fms      , Chs         , Gg^Emf      , Gs^Fp       , Gs^Fms      , Gs^Fds      , Gs^Fds      , Gs^Fds      , Gg          
Gs^Fp       , Gs^Fp       , Gs^Fms      , Gs^Fds      , Gs^Fds      , Gs^Fms      , Gs^Fp       , Gs^Fp       , Gg^Efm      , Gs^Fms      , Gs^Fds      , Gs^Fds      , Gs^Fds      , Gs^Fds      , Gs^Fds      , Gg          , Gg          , Rd          , Rd          , Gg          , Gg          , Gs^Fds      , Gg          , Gg          , Gg          , Gs^Fp       , Gs^Fp       , Gs^Fp       , Gs^Fp       , Gs^Fp       , Gs^Fms      , Gs^Fms      , Ss          , Ss^Vhs      , Gs^Fms      , Gs^Fds      , Gs^Fds      , Gs^Fds      , Gs^Fds      , Gg          
Gs^Fp       , Gs^Fp       , Gs^Fds      , Gs^Fds      , Gs^Fms      , Gs^Fms      , Gg^Efm      , Gg^Efm      , Gs^Fp       , Gs^Fms      , Gg          , Gs^Fds      , Gs^Fds      , Gs^Fds      , Gg          , Gg          , Gg          , Rd          , Rd          , Rd          , Rd          , Gg          , Gs^Fms      , Hh^Fms      , Hh^Fp       , Gg          , Gg          , Gs^Fp       , Gg          , Gs^Fms      , Gs^Fp       , Gg          , Gg          , Gs^Fms      , Gs^Fds      , Gs^Fds      , Gs^Fds      , Gg          , Gg          , Gs^Fds      
Gg          , Ss          , Gg          , Gs^Fds      , Gs^Fms      , Gs^Fp       , Gg          , Gs^Fp       , Gg^Efm      , Gg^Efm      , Gg^Efm      , Gs^Fms      , Gg^Efm      , Gg          , Gg          , Gg          , Gg          , Gg          , Gg          , Rd          , Rd          , Gg          , Gs^Fds      , Hh^Fms      , Hh^Fp       , Hh^Fp       , Hh^Fmf      , Gg          , Gg          , Gs^Fms      , Gs^Fms      , Gg          , Gg          , Gs^Fds      , Gs^Fds      , Gs^Fds      , Gs^Fms      , Gg          , Gg          , Gg          
Gg          , Gg          , Gg          , Gg          , Gs^Fms      , Gs^Fp       , Gg          , Gg          , Gg^Efm      , Gs^Fmf      , Gg          , Hh^Fds      , Hh          , Gg          , Hh^Vhh      , Hh^Fp       , Hh          , Gg          , Gg          , Rd          , Rd          , Gg          , Gg          , Gs^Fms      , Gs^Fms      , Gs^Fmf      , Gg          , Gs^Fp       , Gg          , Gg          , Gg          , Gs^Fp       , Gs^Fms      , Gg          , Gg          , Gg          , Gg          , Gg          , Gg          , Gg          
Gg          , Gg          , Gs^Fp       , Gs^Fp       , Gs^Fms      , Gs^Fds      , Gg          , Gs^Fp       , Gg^Efm      , Gs^Fms      , Hh^Fds      , Hh^Fds      , Mm          , Hh          , Hh          , Hh^Fp       , Hh          , Hh          , Hh^Fds      , Rd          , Rd          , Rd          , Gg          , Gs^Fms      , Gs^Fds      , Gs^Fms      , Gg^Vh       , Gs^Fms      , Gs^Fp       , Gs^Fp       , Gs^Fds      , Gs^Fds      , Gs^Fms      , Gg          , Gg          , Gg          , Gg          , Gg          , Gg          , Gg          
Gg          , Gg          , Gs^Fp       , Gs^Fms      , Gs^Fp       , Gs^Fds      , Gs^Fds      , Gg          , Gg          , Hh          , Mm          , Mm          , Mm          , Mm          , Mm          , Hh          , Hh^Fds      , Hh^Fp       , Hh^Fp       , Gg          , Rd          , Rd          , Gg          , Gg          , Gg          , Gg          , Gg          , Gg          , Gg          , Gs^Fp       , Gg          , Gg          , Gg          , Gg          , Gg          , Gg          , Gg          , Gg^Vc       , Gg          , Gg          
Gg          , Gs^Fp       , Gs^Fms      , Gs^Fds      , Gs^Fds      , Gs^Fms      , Gs^Fds      , Gs^Fds      , Gg          , Hh^Fp       , Mm          , Mm          , Mm          , Mm          , Mm          , Hh          , Hh          , Hh^Fp       , Hh          , Gg          , Rd          , Rd          , Gg          , Gg          , Gg^Efm      , Gg          , Gg          , Gg          , Gg^Efm      , Gg          , Gs^Fp       , Gs^Fms      , Gg          , Gg          , Gg          , Gg^Efm      , Gg^Efm      , Gg          , Gg          , Gg^Efm      
Gg          , Gg          , Gg          , Gs^Fp       , Gs^Fds      , Gs^Fds      , Gs^Fds      , Gs^Fds      , Gg          , Hh^Fp       , Mm          , Mm          , Mm          , Mm          , Mm          , Hh          , Hh          , Hh          , Gg          , Gg          , Rd          , Rd          , Gg          , Gg          , Gg          , Gg^Efm      , Gg          , Gg^Efm      , Gg^Efm      , Gg          , Gs^Fms      , Gs^Fds      , Gs^Fds      , Gg          , Gg          , Gg          , Gg          , Gg^Efm      , Gg^Efm      , Gg^Efm      
Gg          , Gg          , Gg^Efm      , Gg^Ve       , Gs^Fms      , Gs^Fms      , Gs^Fds      , Gs^Fds      , Hh          , Hh^Fp       , Hh^Fp       , Mm          , Hh          , Mm          , Hh          , Hh          , Hh          , Hh          , Gg          , Gg          , Re          , Rd          , Gg          , Gg          , Gg^Efm      , Gg          , Gg^Efm      , Gg          , Gg          , Gg          , Gg          , Gs^Fp       , Gs^Fp       , Gg          , Gg^Efm      , Gg          , Gg          , Gg^Efm      , Gg          , Gg          
Gg          , Hh^Fms      , Hh^Fms      , Gg^Efm      , Gs^Fms      , Gs^Fms      , Gs^Fds      , Gg          , Gg          , Hh^Fds      , Gg          , Hh^Fmf      , Gs^Fmf      , Hh          , Hh          , Hh          , Mm          , Hh          , Hh          , Re^Vct      , Re          , Rd          , Gg          , Gg          , Gg          , Gg          , Gg          , Gg          , Gg          , Gg          , Gg          , Gg          , Gg          , Gg          , Gg          , Gg          , Gg          , Gg          , Gg          , Gg          
Gg          , Hh          , Hh          , Gg          , Gg          , Gs^Fms      , Gs^Fms      , Gg          , Gg          , Gg          , Gg          , Gg          , Gg          , Gg          , Gg          , Hh          , Mm          , Hh          , Hh          , Re          , Re          , Re          , Re          , Gg          , Gg          , Gg          , Gg          , Gg^Efm      , Gg^Efm      , Gg          , Gg          , Gg          , Gg^Efm      , Gg          , Gg          , Gg^Efm      , Gg^Efm      , Gg          , Gg          , Gg          
Gg          , Gg          , Hh          , Gg          , Gg          , Gs^Fms      , Gs^Fms      , Gs^Fms      , Gs^Fms      , Gs^Fms      , Gg          , Gg          , Gg          , Gg          , Gg          , Gg          , Re          , Mm          , Ce          , Ce          , Ce          , Re          , Re^Vct      , Gg          , Re          , Gg          , Gg          , Gg          , Gg          , Gg          , Gg^Efm      , Gg          , Gg          , Gg^Efm      , Gg          , Gg          , Gg^Efm      , Gg          , Gg          , Gg          
Gs^Fds      , Gs^Fds      , Hh^Fms      , Hh          , Hh          , Gs^Fms      , Gg          , Gs^Fms      , Gs^Fms      , Gs^Fms      , Gg          , Gg          , Gg          , Gg          , Gg          , Gg          , Re          , Re          , Ce          , 1 Ke        , Ce          , Re          , Re^Vct      , Re          , Hh^Fds      , Ww          , Ww          , Gg          , Gg^Efm      , Gg^Efm      , Gg          , Gg^Efm      , Hh          , Hh          , Gg          , Gg          , Hh          , Gg          , Gg          , Gg          
Gs^Fms      , Gs^Fds      , Gs^Fds      , Hh^Fms      , Hh          , Gs^Fms      , Gs^Fds      , Gs^Fms      , Gs^Fms      , Gg          , Gs^Fds      , Gg          , Gg          , Gg          , Gg          , Gg          , Re^Vct      , Re          , Re          , Ce          , Hh          , Re          , Hh          , Hh          , Hh^Fmf      , Hh^Fp       , Gg          , Gg          , Gg          , Gg^Efm      , Gg          , Gg          , Hh          , Hh^Fp       , Hh^Fp       , Hh          , Hh          , Hh          , Gg          , Gg          
Gs^Fms      , Gs^Fms      , Gs^Fds      , Gg          , Gg^Efm      , Gg          , Gs^Fds      , Gs^Fds      , Gg          , Gs^Fms      , Gs^Fds      , Gg          , Gg          , Gg          , Gg          , Gg          , Rd          , Re          , Re          , Hh          , Hh          , Hh          , Hh          , Hh^Fp       , Hh          , Gg          , Gg          , Gg          , Gg          , Gg          , Gg^Efm      , Gg          , Hh          , Hh^Fp       , Hh          , Hh^Fp       , Hh          , Hh          , Gg          , Gg          
Gs^Fp       , Gs^Fms      , Gs^Fds      , Gs^Fds      , Gg          , Gg^Efm      , Gg          , Gs^Fds      , Gg          , Gs^Fms      , Gs^Fds      , Gg          , Gg          , Gg          , Gg          , Gg          , Rd          , Rd          , Gg          , Hh          , Mm          , Mm          , Hh          , Hh          , Gg          , Gg          , Gg          , Gg          , Gg          , Gg          , Gg^Efm      , Gg^Efm      , Gg          , Gg          , Hh^Fp       , Hh^Fp       , Hh          , Gg^Efm      , Gg          , Gg          
Gs^Fds      , Gs^Fms      , Gg          , Gs^Fds      , Gg          , Gg^Efm      , Gg^Efm      , Gs^Fds      , Gs^Fds      , Gs^Fms      , Gs^Fds      , Gs^Fds      , Gg          , Gg          , Rd          , Rd          , Rd          , Rd          , Hh          , Hh          , Hh          , Hh          , Hh          , Hh          , Hh          , Gg          , Gg          , Gg          , Gg          , Gg          , Gg          , Gg^Efm      , Hh          , Hh          , Gg          , Hh          , Gg          , Gg          , Gg          , Gg          
Gs^Fds      , Gs^Fds      , Gg^Efm      , Gg^Efm      , Gg^Efm      , Gg^Efm      , Gg          , Gs^Fms      , Gg          , Gs^Fds      , Gg^Efm      , Gg^Efm      , Gg          , Gg          , Rd          , Rd          , Gg          , Hh          , Hh          , Hh          , Hh          , Hh          , Mm          , Mm          , Mm          , Hh          , Hh          , Gg          , Gg          , Gg          , Gg          , Gg          , Gg          , Gg^Efm      , Gg          , Gg          , Gg          , Gg          , Gg          , Gg          
Gg          , Gg          , Gg^Efm      , Gg^Efm      , Gg^Efm      , Gg^Efm      , Gg          , Gg          , Gg          , Gg          , Gg          , Gg          , Gg          , Gg          , Rd          , Rd          , Gg          , Hh          , Hh          , Hh          , Hh          , Hh^Vhh      , Mm          , Mm          , Mm          , Mm          , Hh          , Gg          , Gg          , Gg          , Gg          , Gg          , Gg          , Gg          , Gg          , Gg          , Gg          , Gg          , Gg          , Gg          
Gg          , Gg          , Gg^Efm      , Gg^Efm      , Gg          , Gs^Fp       , Gs^Fms      , Gg          , Gg^Vc       , Gg^Efm      , Gg          , Gg^Efm      , Gg          , Gg          , Rd          , Rd          , Gg          , Gg          , Hh^Fp       , Hh          , Hh          , Mm          , Mm          , Mm          , Mm          , Mm          , Hh          , Gg          , Gg          , Gg          , Gg          , Gg          , Gg          , Gg          , Gg          , Gg          , Gg          , Gg          , Gg          , Gg          
Gg          , Gg          , Gs^Fms      , Gs^Fms      , Gs^Fms      , Gs^Fp       , Gg          , Gg          , Gg          , Gg^Efm      , Gg          , Gg          , Gg          , Gg          , Rd          , Rd          , Gg          , Hh^Fp       , Hh^Fp       , Hh^Fp       , Hh^Fp       , Hh          , Mm          , Mm          , Mm          , Mm          , Hh^Fp       , Hh          , Gg          , Gg          , Gg          , Gg          , Gg          , Gg          , Gg^Vo       , Gg          , Gs^Fp       , Gg          , Gg          , Gg          
Gg          , Gg          , Gg          , Gs^Fms      , Gg          , Gg          , Gg          , Gg          , Gg          , Gg          , Gg          , Gg          , Gs^Fds      , Gg          , Rd          , Rd          , Gg          , Hh^Fp       , Hh          , Hh^Fp       , Hh^Fp       , Hh          , Hh^Fds      , Hh^Fp       , Hh^Fp       , Hh          , Gg          , Gg          , Gg          , Gg          , Gg          , Gg          , Gs^Fds      , Gs^Fp       , Gs^Fmf      , Gs^Fds      , Gs^Fp       , Gg          , Gg^Efm      , Gg^Efm      
Gg          , Gg          , Gg          , Gg          , Gg          , Gs^Fms      , Gg          , Gs^Fms      , Gs^Fds      , Gs^Fds      , Gs^Fds      , Gs^Fds      , Gs^Fms      , Gg          , Rd          , Rd          , Gg          , Gg          , Gg          , Hh          , Hh^Fp       , Gs^Fds      , Gg          , Gg          , Gg          , Hh^Fp       , Gg          , Gg          , Gg          , Gg          , Gg          , Gg          , Gg          , Gs^Fms      , Gg          , Gs^Fmf      , Gg          , Gg^Efm      , Gg^Efm      , Gg          
Gg          , Gg          , Gg          , Gg          , Gg          , Gg          , Gg          , Gs^Fp       , Gs^Fms      , Gs^Fms      , Gg          , Gs^Fms      , Gs^Fms      , Gs^Fms      , Gs^Fms      , Rd          , Rd          , Gg          , Hh          , Gg          , Gg          , Gg          , Gg          , Gg          , Gg          , Gg          , Gg          , Gg          , Gs^Fds      , Gg          , Gg          , Gg          , Gg          , Gg          , Gg          , Gs^Fmf      , Gg          , Gg^Efm      , Gg          , Gg          
Gg          , Gg          , Hh          , Hh^Fp       , Gg          , Gg          , Gg          , Gs^Fds      , Gg          , Gg          , Gs^Fp       , Ss          , Ss          , Gs^Fms      , Gs^Fp       , Rd          , Rd          , Gg          , Gg          , Hh          , Hh          , Gg          , Gg          , Gg          , Gg          , Gg          , Ww          , Gg          , Gg          , Gs^Fds      , Gs^Fds      , Gs^Fds      , Gs^Fds      , Gs^Fds      , Gs^Fp       , Gg          , Gg          , Gg^Efm      , Gg          , Gg          
Gg          , Gg          , Gg          , Hh^Fp       , Gg          , Gg          , Gg          , Gg          , Gg          , Gg          , Gs^Fms      , Gg^Efm      , Gg^Efm      , Ss          , Gs^Fp       , Rd          , Rd          , Gg          , Gg          , Hh          , Gg          , Gg          , Gg          , Gg          , Gg          , Ww          , Ww          , Ww          , Gs^Fds      , Gs^Fds      , Gs^Fms      , Gs^Fms      , Ggf         , Gs^Fp       , Gs^Fp       , Gs^Fp       , Gs^Fp       , Gg          , Gg          , Gg          
Gg          , Gg^Efm      , Gg          , Gg          , Gg          , Gs^Fms      , Gs^Fms      , Gg          , Gg          , Gg          , Gs^Fds      , Gs^Fds      , Gg          , Ss          , Gs^Fp       , Rd          , Rd          , Gg          , Gg          , Gg          , Gg          , Gg          , Gg          , Gg          , Gg          , Ww          , Ww          , Ww          , Gg          , Gs^Fms      , Gs^Fms      , Gg          , Gs^Fp       , Gs^Fms      , Gs^Fp       , Gs^Fms      , Gs^Fp       , Gg          , Gg          , Gg          
Gg          , Gg^Efm      , Gg          , Gg^Efm      , Gs^Fmf      , Gs^Fmf      , Gll^Gvs     , Gs^Fms      , Gs^Fds      , Gs^Fds      , Gs^Fds      , Gs^Fds      , Gs^Fds      , Gs^Fms      , Gs^Fp       , Gs^Fp       , Rd          , Rd          , Gg          , Gs^Fp       , Gs^Fp       , Gg          , Gg          , Gg          , Gg          , Gg          , Ww          , Ww          , Gs^Fp       , Gs^Fms      , Gs^Fp       , Gs^Fp       , Gs^Fds      , Gs^Fds      , Gs^Fds      , Gs^Fp       , Gs^Fms      , Gg          , Gg          , Gg          
Gg          , Gg          , Gs^Fms      , Gs^Fds      , Gg          , Gg^Vl       , Gg          , Gg^Efm      , Gg          , Gs^Fp       , Gs^Fms      , Gs^Fds      , Gs^Fds      , Gs^Fp       , Gs^Fp       , Gs^Fp       , Gg          , Rd          , Rd          , Gg          , Gs^Fp       , Gs^Fp       , Gg          , Gg          , Gs^Fp       , Gg          , Gg          , Gs^Fms      , Gs^Fms      , Gs^Fp       , Gs^Fms      , Gs^Fms      , Gll^Gvs     , Gs^Fds      , Gs^Fms      , Ss          , Gg          , Gs^Fms      , Gs^Fds      , Gs^Fds      
Gs^Fds      , Gs^Fds      , Gs^Fds      , Gs^Fds      , Gs^Fms      , Gg          , Gg^Efm      , Gg          , Gs^Fp       , Gs^Fp       , Gs^Fds      , Gg          , Gs^Fds      , Gs^Fp       , Gs^Fp       , Gg          , Gg^Vo       , Rd          , Rd          , Gg          , Gs^Fp       , Gs^Fmf      , Gg          , Gg          , Gs^Fp       , Gg          , Gs^Fp       , Gs^Fms      , Gs^Fp       , Gs^Fp       , Gs^Fp       , Gll^Gvs     , Gg^Vl       , Gs^Fds      , Gs^Fms      , Gs^Fp       , Gs^Fp       , Gs^Fp       , Gs^Fds      , Gs^Fds      
Gs^Fds      , Gs^Fds      , Gs^Fds      , Gs^Fp       , Gs^Fp       , Gs^Fms      , Gg          , Gs^Fds      , Gs^Fds      , Gs^Fp       , Gs^Fp       , Gg          , Gs^Fms      , Gs^Fms      , Gs^Fp       , Gs^Fp       , Gs^Fp       , Rd          , Rd          , Gg          , Gs^Fp       , Gs^Fp       , Gg          , Gs^Fp       , Gs^Fp       , Gs^Fp       , Gs^Fp       , Gs^Fp       , Ss          , Gs^Fp       , Gg^Emf      , Gs^Fms      , Gs^Fp       , Gg          , Gg          , Gs^Fp       , Gs^Fms      , Gs^Fp       , Gs^Fds      , Gs^Fds      
Gs^Fds      , Gs^Fds      , Gs^Fds      , Gs^Fp       , Gs^Fp       , Gg          , Ss          , Gs^Fds      , Gs^Fds      , Gs^Fp       , Gs^Fp       , Gs^Fms      , Gs^Fms      , Gs^Fp       , Gs^Fp       , Gs^Fp       , Gs^Fp       , Rd          , Rd          , Gg^Efm      , Gg^Efm      , Gs^Fp       , Gs^Fds      , Gs^Fds      , Gs^Fds      , Gs^Fds      , Gs^Fp       , Gs^Fms      , Ss          , Ss          , Gs^Fms      , Gs^Fp       , Gs^Fp       , Gg          , Gs^Fp       , Gg          , Gs^Fp       , Gs^Fms      , Gs^Fds      , Gs^Fds      
Gg          , Gs^Fds      , Gs^Fds      , Gs^Fms      , Gg          , Gg          , Ss          , Gs^Fds      , Gs^Fp       , Gs^Fp       , Gs^Fp       , Gs^Fms      , Gs^Fms      , Gg          , Gs^Fp       , Gs^Fds      , Gs^Fds      , Rd          , Rd          , Gg          , Gg          , Gs^Fms      , Gs^Fds      , Gs^Fds      , Gs^Fp       , Gs^Fms      , Gs^Fds      , Gs^Fms      , Gs^Fms      , Gg^Em       , Gs^Fms      , Gs^Fds      , Gs^Fds      , Gs^Fds      , Gs^Fp       , Gs^Fp       , Gs^Fms      , Gs^Fds      , Gg          , Gs^Fds      
Gg          , Gg          , Gg          , Gs^Fds      , Gg          , Gs^Fp       , Gs^Fms      , Gs^Fp       , Gs^Fms      , Gs^Fds      , Gs^Fp       , Gs^Fp       , Gs^Fp       , Gs^Fds      , Gs^Fds      , Gs^Fds      , 3 Ke        , Ce          , Rd          , Rd          , Gs^Fms      , Gs^Fms      , Gg^Ve       , Gs^Fms      , Gs^Fp       , Gs^Fp       , Gs^Fds      , Gs^Fds      , Gs^Fms      , Gg^Efm      , Gs^Fms      , Gs^Fds      , Gs^Fds      , Gs^Fds      , Gs^Fms      , Gs^Fms      , Hh^Fmf      , Gs^Fds      , Gg          , Gg          
Gs^Fp       , Gg          , Gg          , Gs^Fds      , Gs^Fds      , Gs^Fds      , Gs^Fds      , Gs^Fms      , Gs^Fms      , Gs^Fds      , Gs^Fp       , Gs^Fp       , Gs^Fp       , Gs^Fp       , Gs^Fp       , Ce          , Ce          , Ce          , Rd          , Rd          , Gs^Fms      , Gs^Fms      , Gs^Fms      , Gs^Fds      , Gs^Fds      , Gs^Fms      , Gs^Fds      , Gs^Fds      , Gs^Fds      , Gs^Fms      , Gs^Fp       , Gs^Fms      , Gs^Fms      , Gs^Fms      , Gg^Efm      , Hh^Fmf      , Gg          , Gs^Fmf      , Gg          , Gs^Fms      
Gs^Fp       , Gs^Fp       , Gs^Fp       , Gg          , Gg          , Gg^Efm      , Gs^Fms      , Gs^Fds      , Gs^Fds      , Gs^Fms      , Gg          , Gs^Fp       , Gg          , Gg          , Gg          , Gg          , Gg          , Gg          , Rd          , Rd          , Gg          , Gs^Fms      , Gg          , Gs^Fds      , Gs^Fds      , Gs^Fds      , Gg          , Gs^Fds      , Gg          , Gg          , Hh^Fp       , Gs^Fms      , Hh^Vc       , Hh^Fp       , Hh^Fp       , Hh          , Hh^Fp       , Gs^Fds      , Gs^Fds      , Gs^Fds      
Gs^Fp       , Gs^Fp       , Gs^Fp       , Gg          , Gs^Fp       , Gs^Fms      , Gs^Fp       , Gs^Fms      , Gs^Fds      , Gs^Fds      , Gs^Fds      , Gg          , Gs^Fms      , Gg          , Gs^Vht      , Gg          , Gg          , Gg          , Rd          , Rd          , Gg          , Gg          , Gg          , Gg          , Gg          , Gs^Fp       , Gs^Fp       , Gg          , Gg          , Gg          , Gs^Fp       , Hh^Fp       , Hh^Fp       , Hh^Fp       , Hh^Fp       , Hh^Fp       , Hh^Fp       , Gg          , Gg          , Gg          
Gg^Emf      , Ss          , Ss          , Gs^Fp       , Gs^Fp       , Gg          , Gs^Fp       , Gg          , Gg          , Gs^Fms      , Gs^Fds      , Gs^Fms      , Gs^Fds      , Gs^Fds      , Gs^Fds      , Gg          , Gg          , Gg          , Rd          , Rd          , Gg          , Gg          , Gs^Fp       , Gg          , Gg          , Gs^Fp       , Gs^Fp       , Gs^Fp       , Gs^Fms      , Gs^Fp       , Gs^Fds      , Gs^Fds      , Hh^Fp       , Hh^Fp       , Mm          , Hh^Fp       , Hh^Fp       , Hh^Fp       , Hh          , Gg          
Gg^Emf      , Ss          , Gg          , Gs^Fp       , Gg          , Gs^Fp       , Gg          , Gg          , Gg          , Gg          , Gs^Fms      , Gs^Fds      , Gs^Fds      , Gs^Fds      , Gg          , Gg          , Gg          , Gg          , Rd          , Rd          , Gg          , Gg          , Gs^Fmf      , Gs^Fp       , Gg          , Gs^Fds      , Gs^Fms      , Gs^Fms      , Gs^Fp       , Gs^Fp       , Gs^Fds      , Gs^Fds      , Hh^Fp       , Hh^Fp       , Mm          , Mm          , Mm          , Hh          , Hh          , Gg          
