border_size=1
usage=map

Xu          , Xu          , Xu          , Xu          , Xu          , Xu          , Xu          , Xu          , Xu          , Xu          , Xu          , Xu          , Xu          , Uu          , Uu          , Uu          , Xu          , Xu          , Xu          , Xu          , Xu          , Xu          , Xu          , Xu          , Xu          , Xu          , Xu          , Ww          , Xu          , Xu          , Xu          , Xu          , Xu          , Xu          , Xu          , Xu          , Xu          
Xu          , Xu          , Xu          , Xu          , Xu          , Xu          , Xu          , Xu          , Xu          , Xu          , Xu          , Xu          , Xu          , Uh          , Uu          , Uu          , Uh          , Xu          , Xu          , Xu          , Xu          , Xu          , Xu          , Xu          , Xu          , Xu          , Xu          , Ww          , Xu          , Xu          , Xu          , Xu          , Xu          , Xu          , Xu          , Xu          , Xu          
Xu          , Xu          , Xu          , Xu          , Xu          , Xu          , Xu          , Xu          , Xu          , Xu          , Xu          , Xu          , Xu          , Xu          , Uh          , Uu^Vud      , Uh          , Xu          , Xu          , Xu          , Xu          , Xu          , Xu          , Xu          , Ww          , Ww          , Ww          , Ww          , Xu          , Xu          , Xu          , Xu          , Xu          , Xu          , Xu          , Xu          , Xu          
Xu          , Xu          , Xu          , Xu          , Xu          , Xu          , Ur          , Xu          , Xu          , Xu          , Xu          , Xu          , Xu          , Xu          , Uh          , Ur          , Uu          , Uh          , Uh          , Xu          , Ai          , Xu          , Ww          , Ww          , Xu          , Xu          , Xu          , Xu          , Xu          , Xu          , Xu          , Xu          , Xu          , Xu          , Xu          , Xu          , Xu          
Xu          , Xu          , Xu          , Xu          , Xu          , Ur          , Ur          , Xu          , Xu          , Xu          , Xu          , Xu          , Xu          , Xu          , Uh^Dr       , Ur          , Uu          , Uu          , Ai          , Ai          , Wo          , Wo          , Uh          , Uh          , Qxu         , Xu          , Xu          , Xu          , Xu          , Xu          , Xu          , Xu          , Xu          , Xu          , Xu          , Xu          , Xu          
Xu          , Xu          , Xu          , Xu          , Ur          , Ur          , Xu          , Xu          , Xu          , Xu          , Xu          , Xu          , Xu          , Xu          , Uu^Vu       , Ur          , Ur          , Uu          , Ur          , Ai          , Ai          , Ai          , Uu^Dr       , Uu^Vu       , Cud         , Uu^Vu       , Xu          , Xu          , Xu          , Xu          , Xu          , Xu          , Xu          , Xu          , Xu          , Xu          , Xu          
Xu          , Xu          , Xu          , Ai          , Ai          , Xu          , Xu          , Xu          , Xu          , Xu          , Uu          , Xu          , Xu          , Xu          , Xu          , Uu          , Uu          , Ur          , Ai          , Ai          , Ur          , Uu          , Ur          , Cud         , Cud         , Cud         , Xu          , Xu          , Xu          , Xu          , Xu          , Xu          , Xu          , Xu          , Xu          , Xu          , Xu          
Xu          , Xu          , Ur          , Ur          , Xu          , Xu          , Xu          , Xu          , Qxu         , Uu          , Qxu         , Uu          , Qxu         , Xu          , Xu          , Uh          , Xu          , Ur          , Ur          , Ai          , Ur          , Ur          , Uh          , Cud         , Cud         , 4 Kud       , Xu          , Xu          , Xu          , Xu          , Xu          , Uu^Vud      , Uu^Uf       , Xu          , Xu          , Xu          , Xu          
Xu          , Xu          , Ur          , Xu          , Xu          , Xu          , Xu          , Uu          , Qxu         , Qxu         , Qxu         , Qxu         , Qxu         , Qxu         , Xu          , Xu          , Uu^Dr       , Uu          , Ur          , Ur          , Uu          , Uu          , Uh          , Uh          , Uh^Dr       , Xu          , Xu          , Xu          , Xu          , Xu          , Xu          , Uu^Vud      , Ur          , Uu^Vud      , Xu          , Xu          , Xu          
Xu          , Xu          , Ur          , Ur          , Xu          , Xu          , Xu          , Qxu         , Qxu         , Qxu         , Cud         , Qxu         , Qxu         , Qxu         , Xu          , Xu          , Uu          , Ur          , Uh          , Ur          , Ur          , Uu          , Uu          , Uu^Vud      , Ur          , Xu          , Ur          , Xu          , Xu          , Xu          , Xu          , Xu          , Ur          , Ur          , Xu          , Xu          , Xu          
Xu          , Xu          , Xu          , Ur          , Xu          , Xu          , Xu          , Qxu         , Qxu         , Qxu         , Qxu         , Qxu         , Qxu         , Qxu         , Xu          , Xu          , Uu^Vud      , Ur          , Ur          , Uh          , Uh          , Ur          , Ur          , Ur          , Ur          , Ur          , Xu          , Ur          , Ur          , Ur          , Ur          , Ur          , Xu          , Xu          , Xu          , Xu          , Xu          
Xu          , Xu          , Xu          , Ur          , Qxu         , Xu          , Xu          , Uu          , Uu          , Qxu         , Qxu         , Qxu         , Qxu         , Qxu         , Uu          , Xu          , Uu          , Uu          , Ur          , Uh          , Uu^Dr       , Ur          , Uu^Vud      , Uu          , Uu^Uf       , Xu          , Xu          , Xu          , Xu          , Xu          , Xu          , Uu^Dr       , Uu          , Xu          , Xu          , Xu          , Xu          
Xu          , Xu          , Xu          , Ur          , Xu          , Xu          , Xu          , Xu          , Xu          , Uu          , Qxu         , Qxu         , Xu          , Qxu         , Qxu         , Uu          , Ur          , Ur          , Uu          , Ur          , Uu          , Ur          , Uu          , Uu          , Ww          , Xu          , Xu          , Xu          , Xu          , Xu          , Xu          , Xu          , Xu          , Uu          , Uu          , Xu          , Xu          
Xu          , Xu          , Xu          , Ur          , Xu          , Xu          , Xu          , Xu          , Xu          , Xu          , Xu          , Xu          , Uu          , Uu          , Ur          , Qxu^Bs/     , Qxu         , Uu          , Uu          , Ur          , Uu          , Ur          , Uu          , Ww          , Uu          , Xu          , Uh          , Xu          , Xu          , Xu          , Xu          , Xu          , Xu          , Xu          , Uu          , Xu          , Xu          
Xu          , Xu          , Xu          , Ur          , Xu          , Xu          , Xu          , Xu          , Xu          , Xu          , Xu          , Uu^Dr       , Ur          , Ur          , Ur          , Uu          , Uu^Vu       , Qxu         , Qxu         , Ur          , Ur          , Ur          , Qxu         , Uu          , Qxu         , Uu          , Uu          , Uh          , Uh          , Xu          , Xu          , Xu          , Xu          , Xu          , Xu          , Uu          , Ha          
Xu          , Xu          , Ur          , Ur          , Xu          , Xu          , Xu          , Xu          , Uh          , Ai          , Uu          , Uu          , Ur          , Ur          , Uu          , Uu^Dr       , Qxu         , Qxu         , Uh          , Qxu         , Qxu         , Qxu^Bs\     , Ur          , Qxu         , Uu^Dr       , Qxu         , Qxu         , Uu          , Uu          , Uu^Uf       , Xu          , Xu          , Xu          , Xu          , Ms          , Ms          , Ha          
Xu          , Xu          , Ur          , Xu          , Xu          , Xu          , Xu          , Uh          , Uu          , Uu          , Ur          , Ur          , Uu          , Uu          , Qxu         , Qxu         , Qxu         , Ww          , Wwf         , Uu^Dr       , Uu          , Uu          , Uu          , Ur          , Uu          , Uu          , Qxu         , Uu          , Uu          , Uu          , Uu          , Xu          , Xu          , Xu          , Ms          , Ha^Voa      , Ha          
Xu          , Xu          , Xu          , Ur          , Ur          , Xu          , Xu          , Uu^Vud      , Ur          , Ur          , Uu          , Ur          , Uu          , Uh          , Uu          , Qxu         , Wwf         , Wwf         , Ww          , Uu          , Uh          , Uh          , Uu          , Ur          , Ur          , Uu          , Uu          , Qxu         , Qxu^Bs/     , Uu          , Uu          , Xu          , Xu          , Ms          , Ms          , Ms          , Ha          
Xu          , Xu          , Xu          , Xu          , Xu          , Ur          , Xu          , Ur          , Uu          , Uu          , Uu          , Ur          , Ur          , Ur          , Qxu^Bs\     , Qxu         , Uu          , Wwf         , Ww          , Uu          , Uh          , Uu          , Uu^Vud      , Uu          , Ur          , Ur          , Ur          , Ur          , Uu^Vud      , Qxu         , Qxu         , Xu          , Xu          , Ms          , Ms          , Ha^Voa      , Ha          
Xu          , Xu          , Xu          , Xu          , Xu          , Xu          , Xu          , Uh          , Uh          , Uu          , Uu          , Uu^Uf       , Qxu         , Uu^Vud      , Qxu         , Ur          , Ur          , Uu          , Ww          , Uu          , Uu          , Uu          , Ur          , Ur          , Uu          , Uu          , Xu          , Uh          , Uh          , Uh^Dr       , Xu          , Qxu         , Xu          , Ms          , Ha          , Ha          , Ww          
Xu          , Xu          , Xu          , Xu          , Xu          , Xu          , Xu          , Xu          , Xu          , Uu          , Uu          , Qxu         , Qxu         , Qxu         , Qxu         , Qxu         , Uh          , Ur          , Urb         , Ww          , Wwf         , Ur          , Uu          , Uu          , Uh          , Xu          , Xu          , Xu          , Xu          , Xu          , Xu          , Xu          , Xu          , Ha          , Ww          , Ww          , Ha          
Xu          , Xu          , Xu          , Xu          , Xu          , Xu          , Xu          , Xu          , Xu          , Uu          , Ai          , Ai          , Ai          , Qxu         , Uh          , Uh          , Uh^Dr       , Urb         , Urb         , Urb         , Cud         , Ww          , Ww          , Uu          , Uu          , Uh          , Uh          , Xu          , Xu          , Xu          , Xu          , Xu          , Ha          , Ha          , Ww          , Ha          , Ha          
Xu          , Xu          , Xu          , Xu          , Xu          , Xu          , Xu          , Xu          , Xu          , Ai          , Ai          , Ai          , Ww          , Ai          , Ai          , Uu          , Urb         , Urb         , Cud         , 2 Kud       , Urb         , Urb         , Urb         , Ww          , Ww          , Ai          , Ai          , Ai          , Ai          , Uu^Vud      , Ha          , Ha          , Ww          , Ww          , Ha          , Ha          , Ha          
Xu          , Xu          , Xu          , Xu          , Xu          , Xu          , Xu          , Xu          , Ai          , Ai          , Ww          , Ww          , Wo          , Ww          , Ww          , Ai          , Ai          , Urb         , Urb         , Urb         , Urb         , Urb         , Uu          , Uu          , Uu^Vu       , Ww          , Ww          , Ai          , Ww          , Ha          , Ww          , Ww          , Ai          , Ai          , Xu          , Ha          , Xu          
Xu          , Xu          , Xu          , Xu          , Xu          , Xu          , Xu          , Ai          , Ai          , Ai          , Ww          , Wo          , Wo          , Wo          , Wo          , Ww          , Ww          , Ww          , Ww          , Urb         , Ur          , Ur          , Ur          , Uu          , Ww          , Ww          , Uu          , Ww          , Uh          , Ww          , Ha          , Ha          , Ha          , Ha          , Aa          , Xu          , Xu          
Xu          , Xu          , Xu          , Xu          , Xu          , Xu          , Xu          , Xu          , Uh          , Ai          , Ww          , Wo          , Wo          , Wo          , Ww          , Ww          , Ai          , Ai          , Uu^Vud      , Ww          , Ww          , Ur          , Ur          , Uu          , Ww          , Uu          , Uu          , Uu          , Uu^Dr       , Uh^Ii       , Uh^Ii       , Uh^Ii       , Uh^Ii       , Ha          , Xu          , Aa          , Xu          
Xu          , Xu          , Xu          , Xu          , Xu          , Xu          , Xu          , Xu          , Uh^Dr       , Ai          , Ai          , Ww          , Ww          , Ww          , Ai          , Ai          , Uu^Dr       , Uu          , Uh          , Uu          , Ur          , Ww          , Ww          , Wwf         , Ur          , Uu          , Uh          , Uh          , Xu          , Uh          , Uu^Vud      , Uu^Ufi      , Xu          , Xu          , Xu          , Uu^Ufi      , Xu          
Xu          , Xu          , 3 Kud       , Cud         , Cud         , Xu          , Uu^Vu       , Uu^Vu       , Uu          , Ai          , Ai          , Ai          , Ai          , Ai          , Ur          , Ur          , Cud         , Uh          , Uh          , Uu          , Uu          , Ur          , Ur          , Ur          , Ur          , Ur          , Uh^Dr       , Uh          , Qxu         , Xu          , Xu          , Xu          , Xu          , Xu          , Uu          , Uu^Vu       , Xu          
Xu          , Xu          , Cud         , Cud         , Cud         , Uu^Dr       , Uu          , Ur          , Ur          , Uu          , Uu          , Ai          , Uu^Vud      , Ai          , Ur          , Ur          , Ur          , Uu          , Qxu         , Qxu         , Qxu         , Uu^Vud      , Qxu         , Qxu         , Qxu         , Qxu^Bs|     , Qxu         , Qxu         , Xu          , Xu          , Xu          , Xu          , Xu          , Xu          , Uu          , Xu          , Xu          
Xu          , Xu          , Uu^Uf       , Cud         , Ur^Dr       , Uu          , Ur          , Uu          , Ur          , Ur          , Ur          , Uu          , Ur          , Ur          , Uu          , Uu          , Qxu         , Qxu^Bs\     , Ur          , Uu          , Ur          , Qxu         , Ur          , Qxu         , Ur          , Ur          , Ur          , Uu          , Uh          , Xu          , Uh          , Xu          , Xu          , Xu          , Ur          , Xu          , Xu          
Xu          , Xu          , Xu          , Uh^Dr       , Uh          , Ur          , Uu          , Ur          , Ww          , Ww          , Ww          , Ur          , Xu          , Xu          , Qxu         , Qxu         , Uu          , Uu          , Ur          , Ur          , Uh          , Ur          , Uh          , Ur          , Uu          , Ur          , Ur          , Ur          , Ur          , Uu^Dr       , Ur          , Ur          , Ur          , Ur          , Xu          , Xu          , Xu          
Xu          , Xu          , Xu          , Uh          , Uh          , Uu          , Ur          , Ur          , Ww          , Ww          , Xu          , Xu          , Xu          , Xu          , Qxu         , Xu          , Xu          , Uu^Dr       , Uu^Vud      , Uh          , Xu          , Uh          , Xu          , Xu          , Xu          , Uu          , Uu          , Ur          , Uu          , Ur          , Cud         , Cud         , Uu          , Xu          , Xu          , Xu          , Xu          
Xu          , Xu          , Xu          , Xu          , Xu          , Uh          , Uu^Vud      , Uu          , Xu          , Xu          , Qxu         , Qxu         , Qxu         , Qxu         , Xu          , Xu          , Xu          , Xu          , Xu          , Xu          , Xu          , Xu          , Xu          , Xu          , Xu          , Xu          , Xu          , Xu          , Xu          , Uu^Vud      , Cud         , 1 Kud       , Cud         , Uu          , Uu^Vu       , Xu          , Xu          
Xu          , Xu          , Xu          , Xu          , Xu          , Xu          , Xu          , Xu          , Xu          , Xu          , Xu          , Qxu         , Qxu         , Xu          , Xu          , Xu          , Xu          , Xu          , Xu          , Xu          , Xu          , Xu          , Xu          , Xu          , Xu          , Xu          , Xu          , Xu          , Xu          , Xu          , Xu          , Cud         , Cud         , Uu          , Ur          , Xu          , Xu          
Xu          , Xu          , Xu          , Xu          , Xu          , Xu          , Xu          , Xu          , Xu          , Xu          , Xu          , Xu          , Xu          , Xu          , Xu          , Xu          , Xu          , Xu          , Xu          , Xu          , Xu          , Xu          , Xu          , Xu          , Xu          , Xu          , Xu          , Xu          , Xu          , Xu          , Xu          , Xu          , Xu          , Cud         , Xu          , Xu          , Xu          
